┌──────────────────────────────────────────────────────────────────────────────────────────────────┐
│[iter 3/10] 04:32 | 🔨 Builder | ▶ auto                                                            │
└──────────────────────────────────────────────────────────────────────────────────────────────────┘
┌ Terminal Output ─────────────────────────────────────────────────────────────────────────────────┐
│                                                                                                  │
│                                                                                                  │
│                                                                                                  │
│                                                                                                  │
│                                                                                                  │
│                                                                                                  │
│                                                                                                  │
│                                                                                                  │
│                                                                                                  │
│                                                                                                  │
│                                                                                                  │
│                                                                                                  │
│                                                                                                  │
│                                                                                                  │
│                                                                                                  │
│                                                                                                  │
└──────────────────────────────────────────────────────────────────────────────────────────────────┘
┌──────────────────────────────────────────────────────────────────────────────────────────────────┐
│ Last: build.task                                                                     ◉ active    │
└──────────────────────────────────────────────────────────────────────────────────────────────────┘